11111111111111111111111
1C0P00000000000000000C1
10000000000000000000001
11000000000000001100001
10000000000000001100001
10000001111C00000000001
10000010001111000000001
10011100001E00000000001
11111111111111111111111
