111111111111111111111111111111111111111111111111
100000000000000000000C11C00000000000000000000111
100000000000000000000000000000000000000000000111
110000000000000000000011100000000000000110000111
100000000P00000000000011000000000000000110000111
10000001111C0000000000110000001111C0000000000111
100000011111100000000011000001000111100000000111
10011100001E000000000011001110000100000000000111
111111111111000000000011111111111110111111111111
111111111111000000000011111111111110111111111111
1C0000000000000000000C11C0000000000000000000C111
100000000000000000000011000000000000000000000111
110000000000000000000011100000000000000110000111
100000000000000000000000000000000000001100001111
10000001111C0000000000110000001111C0000000000111
100000100011000000000011000001000111100000000111
100111000010000000000011001110000100000000000111
111111111111001111111111111111111111111111111111
111111111111001111111111111111111111111111111111
1C0000000000000000000C11C0000000000000000000C111
100000000000000000000011000000000000000000000111
100000000000000011000011100000000000000110000111
111000000000000011000000000000000000000110000111
11100000000C0000000000110000001111C0000000000111
111000011111110000000011000001000111100000000111
111000011111110000000011001110000100000000000111
111111111111111111111111111111111111111111111111
