11111111111111111111111
1C000100000000000000001
10000100001000000000001
11000100001000001100001
11100000001000001100001
11100000001000000000001
10000000001111000000001
1P000000001E00000000001
11111111111111111111111