11111111111111111111111
1C0001000000000000000C1
10000100001000000000001
11000100001000001100001
11100000001000001100001
11100000001C00000000001
10000000001111000000001
1P0000C0001E00000000001
11111111111111111111111
