111111111111111111111111111111111111111111111111111111111111111111
100000000000000000000C11C000000000000000t0000000000000000000t00001
10t000000000000000000000000000000000000000000000000000000000t00001
110000000P00000000000011100000000000000110000000000000000000t00001
10000000011111100000001100000t000000000110000000000000000000t00001
10000001111C0000000000110000011111C0000000000000000000000000t00001
100000011111100000000000000000000000000000000000000000000000t00001
10011100001E00000000000000000000000000000000t000000000000000t00001
111111111111000000111111111111111110111111111000000000000000t00001
111111111111000000000011111111111110111111111000000000000000t00001
1C0000000000000000000C11C0000000000000000000C000000000000000t00001
1000000000000000000000000000000000000000t0000000000000000000t00001
110000000000000000000000000000000000000110000000000000000000t00001
1000000000000000000000000000000000000011000011000000000000000t0001
10000001111C0000000000000000001111C0000000000000000000000000000t01
1000t0100011000000000011000001000111100000000000000000000000t00001
100011000010000000000011001110000100000000000000000000000000t00001
111111111111000111111111111111111111111111111000000000000000t00001
111111111111000111111111111111111111111111111000000000000000t00001
1C0000000000000000000C11C0000000000000000000C000000000000000t00001
100000000000000000000011000000000000000000000000000000000000t00001
100000000000000011000000000000000000000110000000000000000000t00001
111000000000t00011000000000000000000000110000000000000000000t00001
11100000000C0000000000000000001111C0000000000000000000000000t00001
111000011111110000000011000001000111100000000000000000000000t00001
111000011111110000000011001110000100000000000000000000000000t00001
100000000000000000000000000000000000000000000000000000000000000001
1C0000000000000000000C11C0000000000000000000C000000000000000t00001
100000000000000000000011000000000000000000000000000000000000t00001
100000000000000011000000000000000000000110000000000000000000t00001
111000000000t00011000000000000000000000110000000000000000000t00001
11100000000C0000000000000000001111C0000000000000000000000000t00001
111000011111110000000011000001000111100000000000000000000000t00001
111000011111110000000011001110000100000000000000000000000000t00001
100000000000000000000000000000000000000000000000000000000000000001
111111111111111111111111111111111111111111111111111111111111111111