111111111111111111111111111111111111111111111111
100000000000000000000C11C000000000000000t0000111
10t000000000000000000000000000000000000000000111
110000000P00000000000011100000000000000110000111
10000000011111100000001100000t000000000110000111
10000001111C0000000000110000011111C0000000000111
100000011111100000000000000000000000000000000111
10011100001E00000000000000000000000000000000t111
111111111111000000111111111111111110111111111111
111111111111000000000011111111111110111111111111
1C0000000000000000000C11C0000000000000000000C111
1000000000000000000000000000000000000000t0000111
110000000000000000000000000000000000000110000111
100000000000000000000000000000000000001100001111
10000001111C0000000000000000001111C0000000000111
1000t0100011000000000011000001000111100000000111
100011000010000000000011001110000100000000000111
111111111111000111111111111111111111111111111111
111111111111000111111111111111111111111111111111
1C0000000000000000000C11C0000000000000000000C111
100000000000000000000011000000000000000000000111
100000000000000011000000000000000000000110000111
111000000000t00011000000000000000000000110000111
11100000000C0000000000000000001111C0000000000111
111000011111110000000011000001000111100000000111
111000011111110000000011001110000100000000000111
111111111111111111111111111111111111111111111111